111111111111
1W0000000001
111000000001
  1000000001
111000111101
1000001  101
101110111001
111 11111111