  111111 111
11100001 101
111000011101
  1000000001
111000111101
1000001  101
101110111101
101 10000001
111 11111111